安保部	安全管理部
安防部	安全管理部
安防事业部	安全管理部
安管部	安全管理部
安监部	安全管理部
安检部	安全管理部
安全部	安全管理部
安全保卫部	安全管理部
安全服务部	安全管理部
安全管理部	安全管理部
安全技术部	安全管理部
安全监察部	安全管理部
安全事业部	安全管理部
安全质量部	安全管理部
保安部	安全管理部
保卫部	安全管理部
保卫处	安全管理部
保卫科	安全管理部
消防部	安全管理部
秩序部	安全管理部
秩序维护部	安全管理部
办事处	办事处
保费部	保费部
保全部	保险部
保险部	保险部
保险理赔部	保险部
保险事业部	保险部
财产险部	保险部
车商部	保险部
车险部	保险部
车险理赔部	保险部
防损部	保险部
核保部	保险部
核保核赔部	保险部
理赔部	保险部
理赔事业部	保险部
寿险部	保险部
寿险事业部	保险部
团险部	保险部
泵送事业部	泵送事业部
编导部	编辑部
编辑部	编辑部
编辑策划部	编辑部
采编部	编辑部
采访部	编辑部
记者部	编辑部
剪辑部	编辑部
美编部	编辑部
排版部	编辑部
杂志部	编辑部
杂志编辑部	编辑部
专刊部	编辑部
组稿部	编辑部
编剧部	编辑部
宾客服务部	宾客服务部
礼品部	宾客服务部
并购部	并购部
财富部	财富管理部
财富管理部	财富管理部
财富管理事业部	财富管理部
财富事业部	财富管理部
财管部	财富管理部
财经部	财富管理部
财经管理部	财富管理部
财会部	财务部
财审部	财务部
财税部	财务部
财务部	财务部
财务本部	财务部
财务处	财务部
财务分析部	财务部
财务管理部	财务部
财务行政部	财务部
财务核算部	财务部
财务会计部	财务部
财务计划部	财务部
财务结算部	财务部
财务科	财务部
财务控制部	财务部
财务企划部	财务部
财务审计部	财务部
财务信息部	财务部
财务运营部	财务部
财务咨询部	财务部
财务资产部	财务部
财务资金部	财务部
财务综合部	财务部
财务总部	财务部
财物部	财务部
财政部	财务部
財務部	财务部
成本部	财务部
成本管理部	财务部
成本合约部	财务部
成本核算部	财务部
成本控制部	财务部
成本预算部	财务部
成控部	财务部
成品部	财务部
出纳部	财务部
代账部	财务部
分公司财务部	财务部
工程审计部	财务部
公司财务部	财务部
行财部	财务部
行政财务部	财务部
核算部	财务部
会计部	财务部
会计服务部	财务部
会计管理部	财务部
会计核算部	财务部
会计结算部	财务部
集团财务部	财务部
集团财务管理部	财务部
集团审计部	财务部
计财部	财务部
计划财务部	财务部
计划管理部	财务部
计划合同部	财务部
记账部	财务部
监察审计部	财务部
结算部	财务部
经营财务部	财务部
决算部	财务部
内控部	财务部
内审部	财务部
内部审计部	财务部
清算部	财务部
区域财务资金部	财务部
审计部	财务部
审计2部	财务部
审计八部	财务部
审计二部	财务部
审计监察部	财务部
审计九部	财务部
审计六部	财务部
审计七部	财务部
审计三部	财务部
审计四部	财务部
审计五部	财务部
审计业务部	财务部
审计一部	财务部
收费部	财务部
收银部	财务部
税务部	财务部
税务事业部	财务部
销售财务部	财务部
预结算部	财务部
预决算部	财务部
预算部	财务部
预算合同部	财务部
预算合约部	财务部
预算经营部	财务部
账务部	财务部
资金部	财务部
资金财务部	财务部
资金管理部	财务部
资金运营部	财务部
综合财务部	财务部
总部财务部	财务部
总公司财务部	财务部
催办	财务部
催收部	财务部
釆购部	采购部
采供部	采购部
采购部	采购部
采购供应部	采购部
采购管理部	采购部
采购计划部	采购部
采购开发部	采购部
采购物流部	采购部
采购销售部	采购部
采購部	采购部
采销部	采购部
採購部	采购部
工程采购部	采购部
国际采购部	采购部
行政采购部	采购部
集团采购部	采购部
计划采购部	采购部
面料采购部	采购部
全球采购部	采购部
商品采购部	采购部
商务采购部	采购部
战略采购部	采购部
餐厅部	餐饮部
餐饮部	餐饮部
餐饮服务部	餐饮部
餐饮事业部	餐饮部
餐飲部	餐饮部
厨部	餐饮部
厨房部	餐饮部
厨务部	餐饮部
传菜部	餐饮部
点心部	餐饮部
酒吧部	餐饮部
酒店餐饮部	餐饮部
酒水部	餐饮部
面包部	餐饮部
散客部	餐饮部
送餐部	餐饮部
西餐部	餐饮部
西点部	餐饮部
宴会部	餐饮部
中餐部	餐饮部
中厨部	餐饮部
咨客部	餐饮部
外场部	餐饮部
仓储部	仓储部
仓储管理部	仓储部
仓储物流部	仓储部
仓管部	仓储部
仓库部	仓储部
仓库管理部	仓储部
仓务部	仓储部
库房部	仓储部
库管部	仓储部
发货部	仓储部
发运部	仓储部
出货部	仓储部
货仓部	仓储部
货代部	仓储部
货品部	仓储部
货运部	仓储部
收发部	仓储部
收货部	仓储部
策划部	策划部
策划编辑部	策划部
策划设计部	策划部
策划推广部	策划部
策划执行部	策划部
产业部	产业部
产业发展部	产业部
厂部	厂务部
厂办	厂务部
厂务部	厂务部
厂务工程部	厂务部
工厂部	厂务部
车管部	车辆管理部
车辆部	车辆管理部
车辆管理部	车辆管理部
车身部	车辆管理部
车务部	车辆管理部
陈列部	陈列部
场外市场部	乘务部
场务部	乘务部
版权部	出版部
出版部	出版部
发行部	出版部
处方部	处方药事业部
处方药事业部	处方药事业部
传媒部	传媒部
传媒事业部	传媒部
船务部	船务部
船员部	船务部
轮机部	船务部
ka部	大客户部
ka事业部	大客户部
ka销售部	大客户部
大客户部	大客户部
大客户服务部	大客户部
大客户事业部	大客户部
大客户销售部	大客户部
大客户业务部	大客户部
重点客户部	大客户部
代表处	代表处
代理部	代理部
代理记账部	代理部
代理事业部	代理部
党群工作部	党群工作部
党委工作部	党群工作部
党委宣传部	党群工作部
党政部	党群工作部
党支部	党群工作部
地产部	地产部
地产工程部	地产部
地产事业部	地产部
地产营销部	地产部
二手房事业部	地产部
房产部	地产部
房产事业部	地产部
房贷部	地产部
房地产部	地产部
房地产开发部	地产部
房地产事业部	地产部
商业地产部	地产部
商业地产事业部	地产部
住宅部	地产部
地接部	地接部
计调部	地接部
地面服务部	地面服务部
电池事业部	电气部
电镀部	电气部
电工部	电气部
电控部	电气部
电力部	电气部
电力事业部	电气部
电气部	电气部
电气工程部	电气部
电气技术部	电气部
电气设计部	电气部
电气事业部	电气部
电仪部	电气部
电源部	电气部
电源事业部	电气部
电装部	电气部
发电部	电气部
弱电部	电气部
弱电工程部	电气部
电网事业部	电网事业部
电购部	电销部
电话部	电销部
电话行销部	电销部
电话销售部	电销部
电销部	电销部
电销事业部	电销部
电信部	电信事业部
电信事业部	电信事业部
电信业务部	电信事业部
电讯部	电信事业部
电子部	电子工程部
电子电器部	电子工程部
电子工程部	电子工程部
电子事业部	电子工程部
电商部	电子商务部
电商设计部	电子商务部
电商事业部	电子商务部
电商运营部	电子商务部
电视购物部	电子商务部
电子商务部	电子商务部
电子商务事业部	电子商务部
电子商务运营部	电子商务部
订单部	电子商务部
订单管理部	电子商务部
跟单部	电子商务部
网购部	电子商务部
电子政务部	电子政务部
电子政务事业部	电子政务部
董事会	董事会
董事长部	董事会
动画部	动漫部
动画制作部	动漫部
动漫部	动漫部
特效部	动漫部
法律部	法务部
法律合规部	法务部
法律事务部	法务部
法务部	法务部
法务合规部	法务部
合规部	法务部
合同部	法务部
合同管理部	法务部
合同预算部	法务部
合约部	法务部
合约成本部	法务部
合约管理部	法务部
合约预算部	法务部
稽查部	法务部
稽核部	法务部
稽核监察部	法务部
稽核审计部	财务部
律师部	法务部
审计法务部	法务部
审批部	法务部
诉讼部	法务部
专案管理部	法务部
大住宿事业部	房务部
房务部	房务部
酒店预订部	房务部
客房部	房务部
客房服务部	房务部
礼宾部	房务部
楼面部	房务部
迎宾部	房务部
预订部	房务部
预定部	房务部
管家部	房务部
放映部	放映部
分销部	分销部
分销事业部	分销部
风控部	风控部
风控合规部	风控部
风险部	风控部
风险管理部	风控部
风险合规部	风控部
风险控制部	风控部
服务部	服务部
服务管理部	服务部
服务事业部	服务部
服务中心	服务部
成衣部	服装部
服饰部	服装部
服装部	服装部
服装开发部	服装部
服装设计部	服装部
服装事业部	服装部
服装业务部	服装部
礼服部	服装部
面料部	服装部
男装部	服装部
女装部	服装部
女装设计部	服装部
童装部	服装部
针织部	服装部
妇产科	妇产科
测绘部	工程部
测量部	工程部
工程部	工程部
工程处	工程部
工程二部	工程部
工程服务部	工程部
工程管理部	工程部
工程技术部	工程部
工程监理部	工程部
工程建设部	工程部
工程开发部	工程部
工程三部	工程部
工程设备部	工程部
工程设计部	工程部
工程师部	工程部
工程实施部	工程部
工程事业部	工程部
工程维护部	工程部
工程维修部	工程部
工程物业部	工程部
工程项目部	工程部
工程项目管理部	工程部
工程销售部	工程部
工程研发部	工程部
工程业务部	工程部
工程一部	工程部
工程预算部	工程部
工程运维部	工程部
工程造价部	造价部
工程指挥部	工程部
工程质量部	工程部
工程咨询部	工程部
公司工程部	工程部
集团工程部	工程部
制图部	工程部
总承包部	工程部
计量部	工程部
监测部	环安部
监察部	监察部
监察稽核部	监察部
监管部	监察部
监控部	监控部
监理部	工程部
监理项目部	工程部
工业部	工艺部
工业工程部	工艺部
工业设计部	工艺部
工业事业部	工艺部
工业装备事业部	工艺部
工艺部	工艺部
工艺工程部	工艺部
工艺技术部	工艺部
工艺开发部	工艺部
工艺设备部	工艺部
工艺设计部	工艺部
工艺研发部	工艺部
工艺质量部	工艺部
公安事业部	公安部
公共关系部	公关部
公共事务部	公关部
公共事业部	公关部
公关部	公关部
公关策划部	公关部
公关活动部	公关部
公关销售部	公关部
外联部	公关部
供销部	供应链管理部
供应部	供应链管理部
供应管理部	供应链管理部
供应链部	供应链管理部
供应链管理部	供应链管理部
供应链事业部	供应链管理部
供应商部	供应链管理部
供应商管理部	供应链管理部
分公司管理部	管理部
高级管理部	管理部
公司管理部	管理部
管理部	管理部
管理处	管理部
管理服务部	管理部
管理科	管理部
管理信息部	管理部
管理中心	管理部
管理咨询部	管理部
管理总部	管理部
管业部	管理部
集团管理部	管理部
总管理部	管理部
光电事业部	光电事业部
广告部	广告部
广告策划部	广告部
广告创意部	广告部
广告设计部	广告部
广告事业部	广告部
广告销售部	广告部
广告宣传部	广告部
广告业务部	广告部
规划部	规划部
规划发展部	规划部
规划建设部	规划部
规划设计部	规划部
轨道交通事业部	轨道交通事业部
澳新部	海外部
出境部	海外部
国际部	海外部
国际工程部	海外部
国际合作部	海外部
国际交流部	海外部
国际结算部	海外部
国际联络部	海外部
国际贸易部	海外部
国际市场部	海外部
国际事务部	海外部
国际事业部	海外部
国际项目部	海外部
国外部	海外部
海外部	海外部
海外财务部	海外部
海外工程部	海外部
海外开发部	海外部
海外市场部	海外部
海外事业部	海外部
海外投资部	海外部
海外拓展部	海外部
海外项目部	海外部
海外销售部	海外部
海外业务部	海外部
海外营业部	海外部
韩国部	海外部
加拿大部	海外部
美国部	海外部
美洲部	海外部
欧美部	海外部
欧美事业部	海外部
欧亚部	海外部
欧洲部	海外部
全球服务部	海外部
日本部	海外部
日本事业部	海外部
日韩部	海外部
亚洲部	海外部
英国部	海外部
海运部	运输部
海运操作部	运输部
海运出口部	运输部
海运进口部	运输部
多元行销部	行销部
行销部	行销部
行销企划部	行销部
行业部	行业部
行业客户部	行业部
行业研究部	行业部
行业应用事业部	行业部
访问部	行政部
档案部	行政部
档案管理部	行政部
行管部	行政部
行政部	行政部
行政服务部	行政部
行政管理部	行政部
行政后勤部	行政部
行政客服部	行政部
行政综合部	行政部
集团行政部	行政部
接待部	行政部
录入部	行政部
内勤部	行政部
内务部	行政部
文员部	行政部
杂货部	行政部
助理部	行政部
资料部	行政部
资料室	行政部
综合行政部	行政部
保洁部	行政部
后勤部	行政部
后勤保障部	行政部
后勤服务部	行政部
后勤管理部	行政部
呼叫中心	客服部
呼叫中心事业部	行政部
呼入部	行政部
总务部	行政部
总务处	行政部
飞行部	航空部
航空部	航空部
航运部	航空部
合作部	合作部
合作发展部	合作部
后期部	后期制作部
后期制作部	后期制作部
保障部	行政部
互联部	互联网事业部
互联网部	互联网事业部
互联网产品部	互联网事业部
互联网金融部	互联网事业部
互联网金融事业部	互联网事业部
互联网开发部	互联网事业部
互联网事业部	互联网事业部
互联网业务部	互联网事业部
互联网运营部	互联网事业部
移动互联网事业部	互联网事业部
护理部	护理部
化工部	化工部
化工事业部	化工部
化学部	化工部
化学合成部	化工部
化验部	化工部
化验室	化工部
彩妆部	化妆部
大众化妆品部	化妆部
化妆部	化妆部
化妆品部	化妆部
化妆品事业部	化妆部
ehs部	环安部
hse部	环安部
安环部	环安部
安全环保部	环安部
环安部	环安部
环保部	环安部
环保事业部	环境事业部
环境部	环境事业部
环境事业部	环境事业部
环评部	环境事业部
会籍部	会籍部
会员部	会籍部
会员服务部	会籍部
会奖部	会奖部
会务部	会务部
收展部	会展部
展会部	会展部
展览部	会展部
机电部	机电部
机电工程部	机电部
机电设备部	机电部
机电设计部	机电部
机电事业部	机电部
机电维修部	机电部
机构部	机构部
机构工程部	机构部
机构客户部	机构部
机构设计部	机构部
机构事业部	机构部
机构研发部	机构部
机构业务部	机构部
机械部	机械部
机械工程部	机械部
机械加工部	机械部
机械设计部	机械部
机械研发部	机械部
机械制造部	机械部
机修部	机械部
基建部	基建部
基建工程部	基建部
基金部	基金部
基金管理部	基金部
基金运营部	基金部
笔记本事业部	计算机事业部
电脑部	计算机事业部
计算机部	计算机事业部
计算机事业部	计算机事业部
多媒体部	技术服务部
多媒体事业部	技术服务部
dt部	技术服务部
电脑技术部	技术服务部
电子技术部	技术服务部
技服部	技术服务部
技术部	研发部
技术保障部	技术服务部
技术二部	研发部
技术发展部	技术服务部
技术服务部	技术服务部
技术工程部	技术服务部
技术工艺部	技术服务部
技术管理部	技术服务部
技术培训部	技术服务部
技术品质部	技术服务部
技术设备部	技术服务部
技术设计部	技术服务部
技术实施部	研发部
技术事业部	研发部
技术维护部	技术服务部
技术维修部	技术服务部
技术项目部	研发部
技术销售部	技术服务部
技术研究部	研发部
技术一部	研发部
技术应用部	技术服务部
技术运营部	技术服务部
技术支撑部	技术服务部
技术支援部	技术服务部
技术质量部	技术服务部
技术中心研发部	研发部
技术咨询部	技术服务部
技術部	研发部
平台技术部	研发部
全球技术服务部	技术服务部
设计技术部	技术服务部
网页设计部	网站事业部
网优部	网站事业部
网优事业部	网站事业部
网游部	网站事业部
网运部	网站事业部
网站部	网站事业部
网站编辑部	网站事业部
网站技术部	网站事业部
网站建设部	网站事业部
网站开发部	网站事业部
网站事业部	网站事业部
微博事业部	微博事业部
微软事业部	微软事业部
应用技术部	技术服务部
生技部	技术服务部
加盟部	加盟部
加盟管理部	加盟部
加盟事业部	加盟部
电器部	家电事业部
家电部	家电事业部
家电事业部	家电事业部
家纺部	家居事业部
家居部	家居事业部
家居事业部	家居事业部
家具部	家居事业部
家装部	装潢装饰部
家装设计部	装潢装饰部
软装部	装潢装饰部
软装设计部	装潢装饰部
装潢部	装潢装饰部
装饰部	装潢装饰部
装饰工程部	装潢装饰部
装维部	装潢装饰部
装修部	装潢装饰部
涂装部	装潢装饰部
建材部	建材部
建设部	建筑部
建设维护部	建筑部
建设系统事业部	建筑部
建筑设计部	建筑部
建筑事业部	建筑部
建筑部	建筑部
建筑工程部	建筑部
健康管理部	健康管理部
健康事业部	健康管理部
健康药物部	健康管理部
健身部	健康管理部
教练部	健康管理部
营养部	健康事业部
营养品部	健康事业部
交付部	交付部
交通部	交通部
交通事业部	交通部
交易管理部	交通部
交易平台事业部	交通部
交易部	交易部
教导部	教务部
教管部	教务部
教师部	教务部
教务部	教务部
教务处	教务部
教学服务部	教务部
教学管理部	教务部
教育培训部	教务部
教育事业部	教务部
教育系统事业部	教务部
教职部	教务部
教质部	教务部
政教部	教务部
助教部	教务部
家教部	教学部
教学部	教学部
教研部	教学部
师资部	教学部
数学部	教学部
私教部	教学部
英语教学部	教学部
幼儿部	教学部
幼教部	教学部
教育部	教育部
宣教部	教育部
播音部	节目部
出品部	节目部
导演部	节目部
节目部	节目部
节目制作部	节目部
剧组部	节目部
栏目部	节目部
节能事业部	节能事业部
结构部	结构部
结构设计部	结构部
个金部	金融事业部
个人部	金融事业部
个人金融部	金融事业部
个人金融服务部	金融事业部
个人金融业务部	金融事业部
个人理财部	金融事业部
个人信贷部	金融事业部
个人业务部	金融事业部
个人银行部	金融事业部
公司金融部	金融事业部
金融部	金融事业部
金融保险部	金融事业部
金融服务部	金融事业部
金融服务事业部	金融事业部
金融工程部	金融事业部
金融机构部	金融事业部
金融市场部	金融事业部
金融事业部	金融事业部
金融同业部	金融事业部
金融投资部	金融事业部
金融物流部	金融事业部
金融业务部	金融事业部
期货部	金融事业部
消费金融部	金融事业部
小企业金融部	金融事业部
小微金融部	金融事业部
综合金融部	金融事业部
经纪部	经纪部
经纪事业部	经纪部
经纪业务部	经纪部
经济部	经济部
经销部	经营部
经营部	经营部
经营管理部	经营部
经营发展部	经营部
经营计划部	经营部
经营企划部	经营部
经营预算部	经营部
经营支援部	经营部
自营部	经营部
精品部	精品部
精算部	精算部
景观部	景观部
景观设计部	景观部
绿化部	景观部
养护部	景观部
园林部	景观部
酒店部	酒店事业部
酒店工程部	酒店事业部
酒店管理部	酒店事业部
酒店事业部	酒店事业部
酒店业务部	酒店事业部
就业部	就业部
劳务部	就业部
军工事业部	军工事业部
科技部	科技管理部
科技发展部	科技管理部
科技管理部	科技管理部
科技信息部	科技管理部
科研部	科技管理部
乘务部	客舱部
客舱部	客舱部
客舱服务部	客舱部
国际客服部	客服部
海外客服部	客服部
话务部	客服部
客服部	客服部
热线部	客服部
营销客服部	客服部
公诉部	公诉部
公务部	公关部
公众客户部	客户部
顾客服务部	客户部
顾客关系部	客户部
贵宾部	客户部
回访部	客户部
集团客户部	客户部
集团客户事业部	客户部
客户部	客户部
要客部	客户部
客服服务部	客户部
客服管理部	客户部
客服事业部	客户部
客服销售部	客户部
客户服务部	客户部
酒店前厅部	客务部
客务部	客务部
前台部	客务部
前厅部	客务部
前厅服务部	客务部
前厅礼宾部	客务部
前厅销售部	客务部
课程部	课程部
空调部	空调部
空调事业部	空调部
控制部	控制部
口腔科	口腔科
宽带事业部	宽带事业部
矿产部	矿产部
理财部	理财部
理财顾问部	理财部
理财事业部	理财部
理财一部	理财部
连锁部	连锁事业部
连锁店管理部	连锁事业部
连锁发展部	连锁事业部
连锁事业部	连锁事业部
连锁运营部	连锁事业部
门店部	连锁事业部
门店管理部	连锁事业部
门店销售部	连锁事业部
门店运营部	连锁事业部
门市部	连锁事业部
联通事业部	联通事业部
猎头部	猎头事业部
猎头事业部	猎头事业部
临床部	临床部
临床事业部	临床部
临床研究部	临床部
临床医学部	临床部
零售部	零售部
零售管理部	零售部
零售市场部	零售部
零售事业部	零售部
零售信贷部	零售部
零售业务部	零售部
零售银行部	零售部
零售运营部	零售部
零售支持部	零售部
流程部	流程部
流程管理部	流程部
流通部	流通部
流通事业部	流通部
导游部	旅游部
旅游部	旅游部
旅游事业部	旅游部
旅游业务部	旅游部
签证部	旅游部
商旅部	旅游部
商旅事业部	旅游部
贸易部	贸易部
贸易金融部	贸易部
贸易融资部	贸易部
内贸部	贸易部
媒介部	媒体部
媒体部	媒体部
媒体事业部	媒体部
媒体运营部	媒体部
美容部	美容部
门诊部	门诊部
治疗部	门诊部
秘书部	秘书部
秘书处	秘书部
文秘部	秘书部
民商部	民商部
成型部	模具部
模具部	模具部
模具工程部	模具部
模具开发部	模具部
模具设计部	模具部
模具事业部	模具部
模具制造部	模具部
模型部	模具部
能源部	能源部
能源事业部	能源部
内训部	培训部
培训部	培训部
培训发展部	培训部
培训管理部	培训部
培训事业部	培训部
实训部	培训部
训练部	培训部
营销培训部	培训部
零件部	配件部
配件部	配件部
配饰部	配饰部
快递部	配送部
快件部	配送部
送货部	配送部
喷漆部	喷漆部
喷涂部	喷漆部
喷油部	喷漆部
批发部	批发部
出票部	票务部
机票部	票务部
机票事业部	票务部
机票业务部	票务部
机票预订部	票务部
票务部	票务部
qa部	品管部
qc部	品管部
安质部	品管部
技质部	品管部
检测部	品管部
品保部	品管部
品管部	品管部
品技部	品管部
品检部	品管部
品控部	品管部
品证部	品管部
品质部	品管部
品质保障部	品管部
品质保证部	品管部
品质工程部	品管部
品质管理部	品管部
品质技术部	品管部
品质控制部	品管部
品質部	品管部
认证部	品管部
体系部	品管部
验货部	品管部
质安部	品管部
质保部	品管部
质管部	品管部
质监部	品管部
质检部	品管部
质控部	品管部
质量部	品管部
质量安全部	品管部
质量保障部	品管部
质量保证部	品管部
质量测试部	品管部
质量工程部	品管部
质量管理部	品管部
质量技术部	品管部
质量监督部	品管部
质量检测部	品管部
质量检验部	品管部
质量控制部	品管部
品牌部	品牌部
品牌策划部	品牌部
品牌发展部	品牌部
品牌公关部	品牌部
品牌管理部	品牌部
品牌企划部	品牌部
品牌设计部	品牌部
品牌市场部	品牌部
品牌事业部	品牌部
品牌销售部	品牌部
品牌形象部	品牌部
品牌宣传部	品牌部
品牌营销部	品牌部
品牌运营部	品牌部
品牌战略部	品牌部
b2b事业部	b2b事业部
o2o事业部	o2o事业部
平台部	平台运营部
平台事业部	平台运营部
平台研发部	平台运营部
平台运营部	平台运营部
评估部	评估部
评级部	评估部
评价部	评估部
筹建部	企划部
计划经营部	企划部
计划调度部	企划部
企管部	企划部
企划部	企划部
企划设计部	企划部
企划宣传部	企划部
企划营销部	企划部
企化部	企划部
企画部	企划部
企宣部	企划部
企业部	企划部
企业策划部	企划部
企业发展部	企划部
企业风险管理部	企划部
企业服务部	企划部
企业管理部	企划部
企业合作部	企划部
企业金融部	企划部
企业客户部	企划部
企业培训部	企划部
企业融资部	企划部
企业事业部	企划部
企业文化部	企划部
企业信息化部	企划部
企业银行部	企划部
商品企划部	企划部
中小企业部	企划部
运筹部	企划部
运筹管理部	企划部
底盘部	汽车部
汽车部	汽车部
汽车电子事业部	汽车部
汽车金融部	汽车部
汽车美容部	汽车部
汽车事业部	汽车部
汽车维修部	汽车部
汽车销售部	汽车部
汽修部	汽车部
前期部	前期部
前期管理部	前期部
前期开发部	前期部
渠道部	渠道部
渠道发展部	渠道部
渠道管理部	渠道部
渠道开发部	渠道部
渠道市场部	渠道部
渠道事业部	渠道部
渠道拓展部	渠道部
渠道销售部	渠道部
渠道业务部	渠道部
渠道营销部	渠道部
渠道运营部	渠道部
市场渠道部	渠道部
现代渠道部	渠道部
新渠道业务部	渠道部
hr部	人事部
财务人事部	人事部
行政及人力资源部	人事部
行政人力部	人事部
行政人力资源部	人事部
行政人事部	人事部
行政人资部	人事部
行政商务部	人事部
行政事务部	人事部
行政事业部	人事部
行政与人力资源部	人事部
行政总务部	人事部
集团行政人事部	人事部
集团人力资源部	人事部
集团人事部	人事部
集团人事行政部	人事部
集团总部人力资源部	人事部
劳动人事部	人事部
人行部	人事部
人力部	人事部
人力行政部	人事部
人力资源部	人事部
人力资源本部	人事部
人力资源管理部	人事部
人力资源行政部	人事部
人力资源及行政部	人事部
人力资源培训部	人事部
人力资源与行政部	人事部
人力资源总部	人事部
人力資源部	人事部
人事部	人事部
人事财务部	人事部
人事处	人事部
人事代理部	人事部
人事服务部	人事部
人事管理部	人事部
人事行政部	人事部
人事行政管理部	人事部
人事及行政部	人事部
人事培训部	人事部
人事外包部	人事部
人事资源部	人事部
人事综合部	人事部
人事总务部	人事部
人资部	人事部
人资行政部	人事部
招聘部	人事部
招聘培训部	人事部
招聘事业部	人事部
综合人事部	人事部
总公司人力资源部	人事部
总部人力资源部	人事部
总务人事部	人事部
组织人事部	人事部
日化部	日化部
赛事部	赛事部
超市部	商超部
超市事业部	商超部
非食品部	商超部
干货部	商超部
国际商务部	商超部
商场部	商超部
商场管理部	商超部
商超部	商超部
商超事业部	商超部
商管部	商超部
商贸部	商超部
百货部	商超部
百货事业部	商超部
玩具部	商超部
游客部	商旅部
游客服务部	商旅部
商品部	商品部
商品管理部	商品部
商品计划部	商品部
翻译部	商务部
商务部	商务部
商务二部	商务部
商务发展部	商务部
商务服务部	商务部
商务管理部	商务部
商务行政部	商务部
商务合约部	商务部
商务合作部	商务部
商务技术部	商务部
商务三部	商务部
商务四部	商务部
商务拓展部	商务部
商务一部	商务部
商户服务部	商业部
商业部	商业部
商业发展部	商业部
商业管理部	商业部
商业事业部	商业部
商用事业部	商业部
路面设备事业部	设备部
配套部	设备部
设备部	设备部
设备保障部	设备部
设备动力部	设备部
设备工程部	设备部
设备管理部	设备部
设备技术部	设备部
设备开发部	设备部
设备能源部	设备部
设备维护部	设备部
设备维修部	设备部
设备物资部	设备部
设备制造部	设备部
装备部	设备部
ui部	设计部
ui设计部	设计部
绘图部	设计部
精装部	设计部
空间部	设计部
空间设计部	设计部
美工部	设计部
平面部	设计部
平面设计部	设计部
三维部	设计部
设计部	设计部
设计策划部	设计部
设计创意部	设计部
设计二部	设计部
设计工程部	设计部
设计管理部	设计部
设计开发部	设计部
设计所部	设计部
设计研发部	设计部
设计一部	设计部
设计院	设计部
设计制作部	设计部
設計部	设计部
视觉部	设计部
视觉陈列部	设计部
视觉设计部	设计部
视觉营销部	设计部
视频部	设计部
视频制作部	设计部
室内部	设计部
室内设计部	设计部
渲染部	设计部
社保部	社保部
社工部	社工部
志愿者部	社工部
社区部	社区部
社区事业部	社区部
涉外部	涉外部
摄像部	摄影部
摄影部	摄影部
摄制部	摄影部
审核部	审核部
定制部	生产部
动力部	生产部
动力设备部	生产部
动力总成部	生产部
工务部	生产部
合成部	生产部
机动部	生产部
机务部	生产部
计划部	生产部
器械部	生产部
pm部	生产部
pmc部	生产部
smt部	生产部
smt工程部	生产部
smt生产部	生产部
安全生产部	生产部
安装部	生产部
钣金部	生产部
包装部	生产部
备件部	生产部
裁床部	生产部
裁剪部	生产部
操作部	生产部
测评部	生产部
测序部	生产部
车间部	生产部
冲压部	生产部
纺织部	生产部
纺织品部	生产部
封装部	生产部
工控部	生产部
工模部	生产部
工装部	生产部
管控部	生产部
焊接部	生产部
机加部	生产部
机加工部	生产部
技术生产部	生产部
加工部	生产部
金型部	生产部
精益生产部	生产部
理货部	生产部
酿造部	生产部
农业部	生产部
生产部	生产部
生产安全部	生产部
生产保障部	生产部
生产本部	生产部
生产采购部	生产部
生产二部	生产部
生产工程部	生产部
生产工艺部	生产部
生产管理部	生产部
生产计划部	生产部
生产技术部	生产部
生产加工部	生产部
生产经营部	生产部
生产控制部	生产部
生产企划部	生产部
生产三部	生产部
生产设备部	生产部
生产设计部	生产部
生产事业部	生产部
生产维修部	生产部
生产物流部	生产部
生产销售部	生产部
生产研发部	生产部
生产一部	生产部
生产营运部	生产部
生产运行部	生产部
生产运营部	生产部
生产运作部	生产部
生产制造部	生产部
生产质量部	生产部
生產部	生产部
生管部	生产部
塑胶部	生产部
调试部	生产部
压铸部	生产部
样品部	生产部
仪表部	生产部
仪器部	生产部
仪器研发部	生产部
原料部	生产部
整车制造部	生产部
纸样部	生产部
制版部	生产部
制程部	生产部
制程工程部	生产部
制工部	生产部
制作部	生产部
製造部	生产部
注塑部	生产部
注塑成型部	生产部
注塑生产部	生产部
铸造部	生产部
装配部	生产部
组装部	生产部
作业部	生产部
生控部	生产部
丝印部	生产部
调度室	生产部
外发部	生产部
中试部	生产部
自控部	生产部
生活部	生活服务部
生活服务部	生活服务部
生计部	生活服务部
水电部	生活服务部
生命科学部	生命科学部
生物部	生命科学部
施工部	施工部
施工管理部	施工部
施工技术部	施工部
施工图部	施工部
施工项目部	施工部
实践部	实施部
实施部	实施部
实施服务部	实施部
果蔬部	生鲜食品部
冷饮事业部	生鲜食品部
奶粉事业部	生鲜食品部
生鲜部	生鲜食品部
生鲜采购部	生鲜食品部
生鲜事业部	生鲜食品部
食品部	生鲜食品部
食品事业部	生鲜食品部
食品销售部	生鲜食品部
酸奶事业部	生鲜食品部
饮料部	生鲜食品部
饮食部	生鲜食品部
bd部	市场部
crm部	市场部
marketing部	市场部
北京市场部	市场部
策略部	市场部
策略采购部	市场部
产品创新部	市场部
产品发展部	市场部
产品市场部	市场部
产品推广部	市场部
创新部	市场部
创新事业部	市场部
创新业务部	市场部
创意部	市场部
创意策划部	市场部
创意设计部	市场部
创作部	市场部
促销部	市场部
大型活动部	市场部
电话营销部	市场部
督察部	市场部
督导部	市场部
方案部	市场部
方案设计部	市场部
供应商开发部	市场部
购买部	市场部
估价部	市场部
广电事业部	市场部
国际营销部	市场部
国内贸易部	市场部
国内市场部	市场部
国内事业部	市场部
互动部	市场部
互动营销部	市场部
会展部	市场部
活动部	市场部
活动策划部	市场部
活动执行部	市场部
集团市场部	市场部
集团营销部	市场部
技术市场部	市场部
解决方案部	解决方案事业部
解决方案事业部	解决方案事业部
经营开发部	市场部
开发采购部	市场部
客户发展部	市场部
客户关爱部	市场部
客户关怀部	市场部
客户关系部	市场部
客户关系管理部	市场部
客户管理部	市场部
客户经理部	市场部
客户开发部	市场部
客户生意发展部	市场部
客户一部	市场部
客户运营部	市场部
客户支持部	市场部
卖场部	市场部
卖场管理部	市场部
内容编辑部	市场部
品牌推广部	市场部
区拓部	市场部
区域管理部	市场部
区域拓展部	市场部
三级市场部	市场部
市場部	市场部
市场部	市场部
市场策划部	市场部
市场传讯部	市场部
市场二部	市场部
市场发展部	市场部
市场分析部	市场部
市场服务部	市场部
市场公关部	市场部
市场管理部	市场部
市场行销部	市场部
市场技术部	市场部
市场经营部	市场部
市场开发部	市场部
市场开拓部	市场部
市场客服部	市场部
市场培训部	市场部
市场品牌部	市场部
市场企划部	市场部
市场三部	市场部
市场商务部	市场部
市场调查部	市场部
市场调研部	市场部
市场推广部	市场部
市场拓展部	市场部
市场项目部	市场部
市场销售部	市场部
市场信息部	市场部
市场研发部	市场部
市场研究部	市场部
市场业务部	市场部
市场一部	市场部
市场营销部	市场部
市场营业部	市场部
市场营运部	市场部
市场与销售部	市场部
市场运营部	市场部
市场战略部	市场部
市场招商部	市场部
市场支持部	市场部
市场咨询部	市场部
数字营销部	市场部
调查部	市场部
调度部	市场部
调研部	市场部
推广部	市场部
网络策划部	市场部
文案部	市场部
文案策划部	市场部
文字编辑部	市场部
线上事业部	市场部
消费品部	市场部
消费品事业部	市场部
销售策划部	市场部
宣传部	市场部
宣传策划部	市场部
宣传推广部	市场部
研究策划部	市场部
邀约部	市场部
战略市场部	市场部
直营销售部	市场部
中国市场部	市场部
资本市场部	市场部
总部市场部	市场部
研展部	市场部
执行部	市场部
拆迁部	市政部
时政部	市政部
市政部	市政部
公司事务部	事务部
事务部	事务部
事业部	事业部
事业2部	事业部
事业二部	事业部
事业发展部	事业部
事业开发部	事业部
事业六部	事业部
事业三部	事业部
事业四部	事业部
事业拓展部	事业部
事业五部	事业部
北京事业部	事业部
第二事业部	事业部
第九事业部	事业部
第六事业部	事业部
第三事业部	事业部
第四事业部	事业部
第五事业部	事业部
第一事业部	事业部
华东事业部	事业部
华南事业部	事业部
华为事业部	事业部
集团事业部	事业部
上海事业部	事业部
事业一部	事业部
中国事业部	事业部
授信管理部	授信管理部
授信评审部	授信管理部
授信审批部	授信管理部
售后部	售后服务部
售后服务部	售后服务部
售后工程部	售后服务部
售后管理部	售后服务部
售后技术部	售后服务部
售后技术服务部	售后服务部
售后客服部	售后服务部
售后维修部	售后服务部
投诉部	售后服务部
维保部	售后服务部
维护部	售后服务部
检修部	售后服务部
检验部	品管部
维修部	售后服务部
维修服务部	售后服务部
维修工程部	售后服务部
修理部	售后服务部
支持部	售后服务部
版房部	售楼部
房产销售部	售楼部
豪宅部	售楼部
售楼部	售楼部
新房部	售楼部
新房事业部	售楼部
置业部	售楼部
售前部	售前技术部
售前技术部	售前技术部
售前支持部	售前技术部
大数据部	数据部
大数据事业部	数据部
数据部	数据部
数据采集部	数据部
数据处理部	数据部
数据分析部	数据部
数据服务部	数据部
数据工程部	数据部
数据管理部	数据部
数据事业部	数据部
数据业务部	数据部
数据运营部	数据部
数据中心	数据部
cnc部	数控部
数控部	数控部
自动化部	数控部
自动化工程部	数控部
自动化事业部	数控部
苹果事业部	数码部
数码部	数码部
数码事业部	数码部
司令部	司令部
体检部	体检部
体育部	体育部
通信部	通信部
通信工程部	通信部
通信事业部	通信部
通讯部	通信部
通讯事业部	通信部
通用事业部	通信部
统筹部	统筹部
统计部	统计部
统计分析部	统计部
投标部	投标部
投行部	投行部
操盘部	投资部
股票投资部	投资部
股权投资部	投资部
固定收益部	投资部
贵宾理财部	投资部
结构融资部	投资部
量化投资部	投资部
权益投资部	投资部
融资部	投资部
融资管理部	投资部
投融部	投资部
投融资部	投资部
投研部	投资部
投资部	投资部
投资发展部	投资部
投资分析部	投资部
投资顾问部	投资部
投资管理部	投资部
投资开发部	投资部
投资理财部	投资部
投资理财一部	投资部
投资事业部	投资部
投资拓展部	投资部
投资项目部	投资部
投资研究部	投资部
投资业务部	投资部
投资一部	投资部
投资银行部	投资部
投资银行事业部	投资部
投资银行业务部	投资部
投资银行总部	投资部
投资运营部	投资部
投资者关系部	投资部
投资咨询部	投资部
证券部	投资部
证券事务部	投资部
证券事业部	投资部
证券投资部	投资部
证券研究部	投资部
直接投资部	投资部
专户投资部	投资部
图书部	图书部
土建部	土建部
土建工程部	土建部
团购部	团购部
团购事业部	团购部
团体业务部	团购部
托管部	托管部
bpo部	外包部
bpo事业部	外包部
外包部	外包部
外包服务部	外包部
外包事业部	外包部
外呼部	外呼部
外交部	外交部
报关部	外贸部
出口部	外贸部
出口业务部	外贸部
单证部	外贸部
对日事业部	外贸部
对外合作部	外贸部
对外联络部	外贸部
对外贸易部	外贸部
关务部	外贸部
国贸部	外贸部
海外贸易部	外贸部
进出口部	外贸部
进出口贸易部	外贸部
进出口业务部	外贸部
进口部	外贸部
清关部	外贸部
入境部	外贸部
通关部	外贸部
外贸部	外贸部
外贸采购部	外贸部
外贸出口部	外贸部
外贸跟单部	外贸部
外贸销售部	外贸部
外贸业务部	外贸部
外勤部	外勤部
外商部	外商部
外事部	外事部
外务部	外务部
外销部	外销部
外协部	外协部
日语部	外语部
外语部	外语部
网络部	网络部
网络安全部	网络部
网络安全事业部	网络部
网络编辑部	网络部
网络发展部	网络部
网络服务部	网络部
网络工程部	网络部
网络管理部	网络部
网络技术部	网络部
网络建设部	网络部
网络金融部	网络部
网络设计部	网络部
网络市场部	网络部
网络事业部	网络部
网络推广部	网络部
网络维护部	网络部
网络系统部	网络部
网络销售部	网络部
网络信息部	网络部
网络营销部	网络部
网络优化部	网络部
网络运维部	网络部
网络运营部	网络部
网络咨询部	网络部
网销部	网络部
文化部	文化部
文件部	文化部
文体部	文化部
文艺部	文化部
无线部	无线事业部
无线产品部	无线事业部
无线生产部	无线事业部
无线事业部	无线事业部
无线网络部	无线事业部
无线研发部	无线事业部
无线业务部	无线事业部
五金部	五金部
耗材部	物料部
材料部	物料部
材料采购部	物料部
材料设备部	物料部
计划物控部	物料部
物料部	物料部
物料管理部	物料部
物料计划部	物料部
cca部	物流部
仓储配送部	物流部
仓储运输部	物流部
仓储运营部	物流部
仓库物流部	物流部
储运部	物流部
分拣部	物流部
国际物流部	物流部
国内物流部	物流部
计划物流部	物流部
交通运输部	物流部
派遣部	物流部
派送部	物流部
配送部	物流部
投递部	物流部
物流部	物流部
物流采购部	物流部
物流仓储部	物流部
物流操作部	物流部
物流管理部	物流部
物流计划部	物流部
物流配送部	物流部
物流事业部	物流部
物流运输部	物流部
物流运营部	物流部
运输部	物流部
运输管理部	物流部
中转部	物流部
综合物流部	物流部
物业部	物业部
物业服务部	物业部
物业工程部	物业部
物业管理部	物业部
物业客服部	物业部
物业项目部	物业部
设施部	物业部
设施管理部	物业部
物管部	物业部
物联网事业部	物业部
物控部	物资部
物资部	物资部
物资采购部	物资部
物资供应部	物资部
物资管理部	物资部
物资设备部	物资部
现场部	现场项目部
现场服务部	现场项目部
现场管理部	现场项目部
现场项目部	现场项目部
现场营运部	现场项目部
大项目部	项目部
第二项目部	项目部
第一项目部	项目部
公司项目部	项目部
华为项目部	项目部
项目部	项目部
项目财务部	项目部
项目策划部	项目部
项目二部	项目部
项目发展部	项目部
项目服务部	项目部
项目工程部	项目部
项目管理部	项目部
项目技术部	项目部
项目监理部	项目部
项目经理部	项目部
项目开发部	项目部
项目三部	项目部
项目设计部	项目部
项目实施部	项目部
项目事业部	项目部
项目投资部	项目部
项目拓展部	项目部
项目销售部	项目部
项目研发部	项目部
项目一部	项目部
项目运营部	项目部
项目执行部	项目部
项目咨询部	项目部
项目组	项目部
重大项目部	项目部
直客部	销售部
临床销售部	销售部
区域销售部	销售部
报价部	销售部
北京销售部	销售部
产品销售部	销售部
产销部	销售部
导购部	销售部
店务部	销售部
二手车部	销售部
个险部	销售部
个险销售部	销售部
个险业务部	销售部
个险营销部	销售部
广州销售部	销售部
国际销售部	销售部
国内销售部	销售部
行业销售部	销售部
华东销售部	销售部
华南区销售部	销售部
华南销售部	销售部
内销部	销售部
全国销售部	销售部
软件销售部	销售部
商务销售部	销售部
上海销售部	销售部
深圳销售部	销售部
销管部	销售部
销售部	销售部
销售1部	销售部
销售2部	销售部
销售本部	销售部
销售二部	销售部
销售发展部	销售部
销售服务部	销售部
销售工程部	销售部
销售管理部	销售部
销售行政部	销售部
销售及市场部	销售部
销售计划部	销售部
销售技术部	销售部
销售交易部	销售部
销售客服部	销售部
销售培训部	销售部
销售企划部	销售部
销售渠道部	销售部
销售三部	销售部
销售商务部	销售部
销售市场部	销售部
销售事业部	销售部
销售四部	销售部
销售推广部	销售部
销售拓展部	销售部
销售五部	销售部
销售业务部	销售部
销售一部	销售部
销售营业部	销售部
销售营运部	销售部
销售与市场部	销售部
销售运营部	销售部
销售运作部	销售部
销售支持部	销售部
销售总部	销售部
銷售部	销售部
宴会销售部	销售部
校园部	校园招聘部
校园招聘部	校园招聘部
新媒体部	新媒体运营部
新媒体事业部	新媒体运营部
新媒体运营部	新媒体运营部
新能源事业部	新能源事业部
经济新闻部	新闻部
社会新闻部	新闻部
新闻部	新闻部
新闻编辑部	新闻部
新闻采编部	新闻部
要闻部	新闻部
专题部	新闻部
按揭部	信贷部
车贷部	信贷部
贷后管理部	信贷部
贷款部	信贷部
贷款事业部	信贷部
担保部	信贷部
担保业务部	信贷部
个贷部	信贷部
个人贷款部	信贷部
信保部	信贷部
信贷部	信贷部
信贷管理部	信贷部
信贷审批部	信贷部
信贷业务部	信贷部
信控部	信贷部
信审部	信贷部
信托业务部	信贷部
信用保证保险事业部	信贷部
信用管理部	信贷部
信用卡部	信贷部
电子信息部	信息部
电脑信息部	信息部
集团信息部	信息部
信息部	信息部
信息安全部	信息部
信息安全事业部	信息部
信息服务部	信息部
信息工程部	信息部
信息管理部	信息部
信息化部	信息部
信息化管理部	信息部
信息化事业部	信息部
信息技术部	信息部
信息技术管理部	信息部
信息技术总部	信息部
信息开发部	信息部
信息科技部	信息部
信息事业部	信息部
信息网络部	信息部
信息系统部	信息部
信息中心	信息部
信息咨询部	信息部
信息资源部	信息部
学工部	学工部
学管部	学术部
学术部	学术部
学术推广部	学术部
学习部	学术部
押运部	押运部
烟草事业部	烟草事业部
it部	研发部
it 部	研发部
it服务部	研发部
it管理部	研发部
it事业部	研发部
it信息部	研发部
it研发部	研发部
集成部	研发部
集成事业部	研发部
软件部	研发部
软件测试部	研发部
软件产品部	研发部
软件二部	研发部
软件服务部	研发部
软件工程部	研发部
软件技术部	研发部
软件开发部	研发部
软件开发二部	研发部
软件开发事业部	研发部
软件开发一部	研发部
软件三部	研发部
软件设计部	研发部
软件实施部	研发部
软件事业部	研发部
软件项目部	研发部
软件研发部	研发部
软件研发一部	研发部
软件业务部	研发部
软件一部	研发部
商用软件事业部	研发部
试验部	研发部
系统部	研发部
系统测试部	研发部
系统服务部	研发部
系统工程部	研发部
系统管理部	研发部
系统集成部	研发部
系统集成事业部	研发部
新品部	研发部
amp部	研发部
android开发部	研发部
android研发部	研发部
erp部	研发部
erp实施部	研发部
erp事业部	研发部
ia事业部	研发部
ic设计部	研发部
ie部	研发部
ios开发部	研发部
ios研发部	研发部
it技术部	研发部
it开发部	研发部
it运维部	研发部
java开发部	研发部
java软件开发部	研发部
java研发部	研发部
net开发部	研发部
pe部	研发部
rd部	研发部
sap部	研发部
scm部	研发部
web开发部	研发部
安全产品部	研发部
安卓开发部	研发部
半导体事业部	研发部
北京研发部	研发部
编程部	研发部
测试部	研发部
测试工程部	研发部
测试技术部	研发部
测试开发部	研发部
测试一部	研发部
产品部	研发部
产品测试部	研发部
产品策划部	研发部
产品二部	研发部
产品服务部	研发部
产品工程部	研发部
产品供应部	研发部
产品管理部	研发部
产品规划部	研发部
产品技术部	研发部
产品开发部	研发部
产品企划部	研发部
产品设计部	研发部
产品实施部	研发部
产品事业部	研发部
产品项目部	研发部
产品研发部	研发部
产品一部	研发部
产品支持部	研发部
产品制造部	研发部
产品质量部	研发部
程序部	研发部
程序开发部	研发部
第二开发部	研发部
第三开发部	研发部
第一开发部	研发部
电子开发部	研发部
电子研发部	研发部
对日开发部	研发部
机器人事业部	研发部
基础部	研发部
基础架构部	研发部
基础研发部	研发部
技术产品部	研发部
技术开发部	研发部
技术研发部	研发部
技术运维部	研发部
技术支持部	研发部
架构部	研发部
健康产品事业部	研发部
金融产品部	研发部
开发部	研发部
开发2部	研发部
开发本部	研发部
开发二部	研发部
开发工程部	研发部
开发管理部	研发部
开发技术部	研发部
开发配套部	研发部
开发三部	研发部
开发设计部	研发部
开发事业部	研发部
开发四部	研发部
开发一部	研发部
科技开发部	研发部
平台开发部	研发部
前端开发部	研发部
嵌入式开发部	研发部
嵌入式软件部	研发部
嵌入式软件事业部	研发部
嵌入式事业部	研发部
商品开发部	研发部
商业智能部	研发部
上海研发部	研发部
设备研发部	研发部
深圳研发部	研发部
市场产品部	研发部
手机部	研发部
手机测试部	研发部
手机开发部	研发部
手机事业部	研发部
手机销售部	研发部
手机研发部	研发部
手游部	研发部
手游事业部	研发部
搜索技术部	研发部
搜索事业部	研发部
算法部	研发部
网管部	研发部
网建部	研发部
网路部	研发部
网络产品部	研发部
网络开发部	研发部
网络研发部	研发部
系统技术部	研发部
系统开发部	研发部
系统软件部	研发部
系统设计部	研发部
系统实施部	研发部
系统事业部	研发部
系统维护部	研发部
系统研发部	研发部
系统应用部	研发部
系统运行部	研发部
系统运维部	研发部
系统运营部	研发部
系统支撑部	研发部
系统支持部	研发部
芯片部	研发部
新产品部	研发部
新产品导入部	研发部
新产品开发部	研发部
新产品事业部	研发部
新产品研发部	研发部
新品开发部	研发部
新药部	研发部
新药研发部	研发部
研发部	研发部
研发2部	研发部
研发测试部	研发部
研发二部	研发部
研发工程部	研发部
研发管理部	研发部
研发技术部	研发部
研发三部	研发部
研发设计部	研发部
研发生产部	研发部
研发事业部	研发部
研发四部	研发部
研发一部	研发部
研发中心测试部	研发部
研發部	研发部
研究发展部	研发部
研究开发部	研发部
移动产品部	研发部
移动开发部	研发部
应用开发部	研发部
应用软件部	研发部
应用软件开发部	研发部
应用系统部	研发部
应用研发部	研发部
硬件测试部	研发部
硬件开发部	研发部
硬件设计部	研发部
硬件研发部	研发部
优化部	研发部
游戏开发部	研发部
游戏研发部	研发部
预研部	研发部
原画部	研发部
云计算事业部	研发部
运维部	研发部
运维服务部	研发部
运维管理部	研发部
制剂部	研发部
终端部	研发部
终端产品部	研发部
终端管理部	研发部
终端事业部	研发部
终端销售部	研发部
终端研发部	研发部
注册部	研发部
自动化开发部	研发部
硬件部	研发部
分析部	研究部
实验部	研究部
研究部	研究部
演出部	演艺部
演艺部	演艺部
艺人部	演艺部
养殖部	养殖部
业管部	业管部
对公业务部	业务部
公司业务部	业务部
国际业务部	业务部
国内业务部	业务部
国外业务部	业务部
上海业务部	业务部
新业务部	业务部
业务部	业务部
业务2部	业务部
业务二部	业务部
业务发展部	业务部
业务跟单部	业务部
业务管理部	业务部
业务开发部	业务部
业务六部	业务部
业务三部	业务部
业务四部	业务部
业务推广部	业务部
业务拓展部	业务部
业务五部	业务部
业务销售部	业务部
业务一部	业务部
业务运营部	业务部
业务支撑部	业务部
业务支持部	业务部
业务咨询部	业务部
液态奶事业部	业务部
業務部	业务部
中国业务部	业务部
总行公司业务部	业务部
拓展部	业务部
糖尿病事业部	医疗事业部
外科	医疗事业部
心血管事业部	医疗事业部
医疗部	医疗事业部
医疗器械部	医疗事业部
医疗事业部	医疗事业部
医疗卫生事业部	医疗事业部
医疗系统事业部	医疗事业部
肿瘤部	医疗事业部
肿瘤事业部	医疗事业部
医务部	医药部
医学事务部	医药部
医学部	医药部
otc部	医药部
otc事业部	医药部
otc销售部	医药部
药房部	医药部
药剂科	医药部
药理部	医药部
药品部	医药部
药品事业部	医药部
药品销售部	医药部
药物化学部	医药部
药学部	医药部
医药部	医药部
医药事业部	医药部
医院部	医药部
医院事业部	医药部
医院销售部	医药部
疫苗部	医药部
中药部	医药部
移动部	移动事业部
移动互联部	移动事业部
移动互联事业部	移动事业部
移动互联网部	移动事业部
移动事业部	移动事业部
移动项目部	移动事业部
移动研发部	移动事业部
移动业务部	移动事业部
移动应用事业部	移动事业部
移动终端事业部	移动事业部
茶艺部	艺术部
美术部	艺术部
美术设计部	艺术部
手工部	艺术部
艺术部	艺术部
音乐部	艺术部
银保部	银保部
银代部	银保部
银行保险部	银保部
银行事业部	银保部
银行业务部	银保部
电子银行部	银行部
私人银行部	银行部
同业部	银行部
银行部	银行部
银行卡部	银行部
公司银行部	银行部
商业银行部	银行部
印前部	印刷部
印刷部	印刷部
印刷系统事业部	印刷部
营建部	营建部
服务营销部	营销部
营销部	营销部
营销本部	营销部
产品营销部	营销部
国内营销部	营销部
海外营销部	营销部
营销财务部	营销部
营销策划部	营销部
营销二部	营销部
营销服务部	营销部
营销管理部	营销部
营销管理总部	营销部
营销企划部	营销部
营销三部	营销部
营销事业部	营销部
营销四部	营销部
营销推广部	营销部
营销拓展部	营销部
营销业务部	营销部
营销一部	营销部
营销支持部	营销部
营销中心客服部	营销部
营销中心市场部	营销部
营销总部	营销部
整合营销部	营销部
营管部	营业部
北京营业部	营业部
分行营业部	营业部
广州营业部	营业部
上海营业部	营业部
深圳营业部	营业部
营业部	营业部
营业本部	营业部
营业二部	营业部
营业管理部	营业部
营业技术部	营业部
营业企划部	营业部
营业三部	营业部
营业四部	营业部
营业一部	营业部
営業部	营业部
營業部	营业部
总行营业部	营业部
支行营业部	营业部
营运部	营运部
营运管理部	营运部
营运支持部	营运部
影视部	影视部
影视制作部	影视部
影像部	影视部
制片部	影视部
应用部	应用部
应用服务部	应用部
应用工程部	应用部
应用集成部	应用部
游戏部	游戏事业部
游戏策划部	游戏事业部
游戏事业部	游戏事业部
在线游戏事业部	游戏事业部
俱乐部	娱乐部
康乐部	娱乐部
康体部	娱乐部
温泉部	娱乐部
休闲部	娱乐部
娱乐部	娱乐部
运管部	运行部
运行部	运行部
运行保障部	运行部
运行维护部	运行部
运作部	运行部
运作管理部	运行部
陆运部	运输部
拼箱部	运输部
客运部	运输部
空运部	运输部
空运出口部	运输部
空运进口部	运输部
汽运部	运输部
服务运营部	运营部
社区运营部	运营部
策划运营部	运营部
产品运营部	运营部
店铺运营部	运营部
海外运营部	运营部
集团运营部	运营部
计划运营部	运营部
竞价部	运营部
客服运营部	运营部
内容部	运营部
内容运营部	运营部
商品运营部	运营部
商务运营部	运营部
商业运营部	运营部
网站运营部	运营部
线上运营部	运营部
用户服务部	运营部
用户体验部	运营部
游戏运营部	运营部
运行管理部	运营部
运营部	运营部
运营保障部	运营部
运营策划部	运营部
运营二部	运营部
运营服务部	运营部
运营管理部	运营部
运营技术部	运营部
运营客服部	运营部
运营三部	运营部
运营商部	运营部
运营商事业部	运营部
运营市场部	运营部
运营事业部	运营部
运营四部	运营部
运营推广部	运营部
运营维护部	运营部
运营一部	运营部
运营支撑部	运营部
运营支持部	运营部
运营总部	运营部
资本运营部	运营部
综合运营部	运营部
造价部	造价部
造价采购部	造价部
造价合约部	造价部
造价咨询部	造价部
形象部	造型部
形象设计部	造型部
美发部	造型部
造型部	造型部
增值部	增值服务部
增值服务部	增值服务部
增值事业部	增值服务部
增值维护部	增值服务部
增值业务部	增值服务部
债权部	债权部
发展部	战略部
发展规划部	战略部
战略部	战略部
战略发展部	战略部
战略管理部	战略部
战略规划部	战略部
战略合作部	战略部
战略客户部	战略部
战略企划部	战略部
战略投资部	战略部
战略咨询部	战略部
招商部	招商部
招商管理部	招商部
招商事业部	招商部
招商银行部	招商部
招商营运部	招商部
招商运营部	招商部
招生部	招生部
招生办	招生部
招标部	招投部
招标采购部	招投部
招标代理部	招投部
招投部	招投部
招投标部	招投部
照明事业部	照明事业部
政府部	政府事业部
政府事务部	政府事业部
政府事业部	政府事业部
政企部	政府事业部
政企客户部	政府事业部
政企事业部	政府事业部
政治部	政府事业部
53在线支付部	支付部
支援部	支援部
知识产权部	知识产权
专利部	知识产权
直销部	直销部
直营部	直营部
直营管理部	直营部
直营事业部	直营部
协调各部	职能部
职能部	职能部
smt制造部	制造部
制造部	制造部
制造二部	制造部
制造工程部	制造部
制造管理部	制造部
制造技术部	制造部
制造三部	制造部
制造事业部	制造部
制造一部	制造部
智慧城市事业部	智慧城市事业部
智能交通事业部	智能交通事业部
住院部	住院部
专业服务部	专业服务部
顾问部	咨询部
咨询部	咨询部
咨询服务部	咨询部
咨询顾问部	咨询部
咨询管理部	咨询部
咨询实施部	咨询部
咨询事业部	咨询部
咨询项目部	咨询部
咨询业务部	咨询部
资材部	资材管理部
资材管理部	资材管理部
资财部	资材管理部
资产部	资产管理部
资产保护部	资产管理部
资产保全部	资产管理部
资产财务部	资产管理部
资产服务部	资产管理部
资产管理部	资产管理部
资产管理总部	资产管理部
资产经营部	资产管理部
资产评估部	资产管理部
资产托管部	资产管理部
资产运营部	资产管理部
资管部	资产管理部
资讯部	资讯部
资讯管理部	资讯部
资讯科技部	资讯部
资源部	资源部
资源管理部	资源部
资源开发部	资源部
資源部	资源部
综管部	综合管理部
综合部	综合管理部
综合保障部	综合管理部
综合处	综合管理部
综合服务部	综合管理部
综合管理部	综合管理部
综合计划部	综合管理部
综合开拓部	综合管理部
综合事务部	综合管理部
综合事业部	综合管理部
综合项目部	综合管理部
综合业务部	综合管理部
综合支持部	综合管理部
总裁部	总裁办
总经部	总裁办
经理部	经理部
总经理部	总裁办
总经理办公室	总裁办
总经理工作部	总裁办
租赁部	租赁部
组立部	组织部
组团部	组织部
组织部	组织部
组织发展部	组织部
